width = 20
height = 15
lumiSpawnX = 18
lumiSpawnY = 12
pattouSpawnX = 4
pattouSpawnY = 12
tiles =
1	1	1	1	1	1	1	1	1	1	1	1	1	1	1	1	1	1	1	1
3	2	2	2	2	2	2	2	2	2	2	2	2	2	2	2	2	2	1	1
3	2	2	2	2	2	2	2	2	2	2	2	2	2	2	2	2	2	2	1
1	1	1	1	1	3	3	1	1	1	1	1	2	2	2	2	2	2	2	1
3	2	2	2	2	2	2	2	2	2	2	3	2	2	2	2	2	2	2	1
3	2	2	2	2	2	2	2	2	2	2	3	2	2	2	2	2	2	2	1
3	2	2	2	2	2	2	2	2	2	2	1	2	2	2	2	1	2	1	1
1	1	1	1	1	2	2	2	1	1	5	1	1	1	2	2	1	1	1	1
1	2	2	2	2	2	2	2	2	2	6	1	1	2	2	2	2	2	1	1
1	2	2	2	2	2	1	2	2	2	6	1	2	2	2	2	2	2	2	1
1	1	1	1	1	1	1	2	2	2	6	3	2	2	2	2	2	2	2	1
1	2	2	2	2	2	1	2	2	2	6	3	2	2	2	2	2	2	2	1
1	2	2	2	2	2	2	2	2	2	6	1	2	2	1	2	2	2	2	1
1	2	2	2	2	2	2	2	2	2	7	1	2	2	1	1	2	2	1	1
1	1	1	1	1	1	1	1	1	1	1	1	1	1	1	1	1	1	1	1
entities =
2 2 9 201 2.0 5.0 
