width = 20
height = 15
lumiSpawnX = 18
lumiSpawnY = 12
pattouSpawnX = 4
pattouSpawnY = 14
tiles =
1	1	1	1	1	1	1	1	1	1	1	1	1	1	1	1	1	1	1	1
2	2	2	2	2	2	2	2	2	2	2	2	2	2	2	2	2	2	1	1
2	2	2	2	2	2	2	2	2	2	2	2	2	2	2	2	2	2	2	1
1	1	1	1	1	3	3	1	1	1	1	1	2	2	2	2	2	2	2	1
2	2	2	2	2	2	2	2	2	2	2	3	2	2	2	2	2	2	2	1
2	2	2	2	2	2	2	2	2	2	2	3	2	2	2	2	2	2	2	1
2	2	2	2	2	2	2	2	2	2	2	1	2	2	2	2	1	2	1	1
1	1	1	1	1	2	2	2	1	1	2	1	1	1	2	2	1	1	1	1
1	2	2	2	2	2	2	2	2	2	2	1	1	2	2	2	2	2	1	1
1	2	2	2	2	2	1	2	2	2	2	1	2	2	2	2	2	2	2	1
1	1	1	1	1	1	1	2	2	2	2	3	2	2	2	2	2	2	2	1
1	2	2	2	2	2	1	2	2	2	2	3	2	2	2	2	2	2	2	1
1	2	2	2	2	2	2	2	2	2	2	1	2	2	1	2	2	2	2	1
1	2	2	2	2	2	2	2	2	2	2	1	2	2	1	1	2	2	1	1
1	1	1	1	1	1	1	1	1	1	1	1	1	1	1	1	1	1	1	1