width = 20
height = 15
lumiSpawnX = 18
lumiSpawnY = 2
pattouSpawnX = 18
pattouSpawnY = 6
tiles =
1	3	3	3	1	3	3	1	1	1	1	1	1	1	1	1	1	1	1	1
1	2	2	6	1	2	2	2	2	2	2	2	2	2	2	2	2	2	2	3
1	2	2	6	1	2	2	2	2	2	2	2	2	2	2	2	2	2	2	3
1	2	2	7	1	2	2	2	2	2	2	2	1	1	1	2	2	1	1	1
1	5	2	2	1	3	3	3	1	1	1	1	1	1	2	2	2	2	2	3
1	6	2	2	2	2	2	2	2	2	2	2	1	2	2	2	2	2	2	3
1	7	2	2	2	2	2	2	2	2	2	2	1	2	2	2	2	2	2	3
1	1	1	2	2	2	2	1	1	2	2	2	1	2	2	2	1	1	1	1
1	1	1	1	4	2	2	2	2	2	2	1	4,2	2	2	2	2	2	1	1
1	2	2	2	2	2	2	2	2	2	2	2	4,2	2	2	2	2	2	2	1
1	2	2	2	2	2	2	2	2	1	1	1	1	2	2	2	2	2	2	1
1	9	2	2	2	1	1	2	2	2	2	2	2	2	2	2	2	1	5	1
1	1	8,1	2	2	2	2	2	2	2	2	2	2	2	2	2	2	2	6	1
1	1	1	8,1	2	2	2	2	2	2	2	2	2	2	2	2	2	2	7	1
1	1	1	4	4	1	1	1	1	1	1	1	1	1	1	1	1	1	1	1
entities = 
5 17 10 200 3 30 300
6 5 1 600 2 1 false
6 3 1 601 1 1 true
4 1 11 400 1 1