width = 15
height = 15
lumiSpawnX = 12
lumiSpawnY = 3
pattouSpawnX = 2
pattouSpawnY = 2
tiles =
1	1	1	1	1	1	1	1	1	1	1	1	1	1	1
1	2	0	2	2	2	2	2	2	2	2	2	2	2	1
1	2	0	2	2	2	2	2	2	2	2	2	2	2	1
1	1	1	1	1	1	1	1	1	1	2	2	2	2	1
1	10	9	9	9	9	9	9	8	1	2	2	2	11	1
1	2	2	2	2	2	2	2	9	1	2	2	1	1	1
1	2	2	1	2	2	2	2	9	1	2	2	2	2	1
1	2	2	1	2	2	2	2	9	1	2	2	2	2	1
1	2	2	1	8	2	1	1	1	1	1	1	1	2	1
1	2	2	1	9	2	2	2	2	2	2	2	2	2	1
1	2	2	1	10	2	2	2	2	2	2	2	2	11	1
1	2	2	1	1	1	1	1	1	1	1	1	1	1	1
1	2	2	2	2	2	2	2	2	2	2	2	0	2	1
1	2	2	2	2	2	2	2	2	2	2	2	0	2	1
1	1	1	1	1	1	1	1	1	1	1	1	1	1	1
entities =
3 12 12 301 1 2 cutscene4 
