width = 15
height = 15
lumiSpawnX = 12
lumiSpawnY = 3
pattouSpawnX = 2
pattouSpawnY = 2
tiles =
1	1	1	1	1	1	1	1	1	1	1	1	1	1	1
1	2	0	2	2	2	2	2	2	2	2	2	2	2	1
1	2	0	2	2	2	2	2	2	2	2	2	2	2	1
1	1	1	1	1	1	1	1	1	1	2	2	2	2	1
1	7	6	6	6	6	6	6	5	1	2	2	2	8	1
1	2	2	2	2	2	2	2	6	1	2	2	1	1	1
1	2	2	1	2	2	2	2	6	1	2	2	2	2	1
1	2	2	1	2	2	2	2	6	1	2	2	2	2	1
1	2	2	1	5	2	1	1	1	1	1	1	1	2	1
1	2	2	1	6	2	2	2	2	2	2	2	2	2	1
1	2	2	1	7	2	2	2	2	2	2	2	2	8	1
1	2	2	1	1	1	1	1	1	1	1	1	1	1	1
1	2	2	2	2	2	2	2	2	2	2	2	0	2	1
1	2	2	2	2	2	2	2	2	2	2	2	0	2	1
1	1	1	1	1	1	1	1	1	1	1	1	1	1	1
entities =
3 12 12 301 1 2 cutscene4 
