width = 10
height = 10
spawnX = 5
spawnY = 5
tiles = 
0	0	0	0	0	0	0	0	0	0
0	1	1	1	1	1	1	1	1	0
0	1	1	1	1	1	1	1	1	0
0	1	1	1	1	1	1	1	1	0
0	1	1	1	1	1	1	1	1	0
0	1	1	1	1	2	2	1	1	0
0	1	1	1	2	2	2	1	1	0
0	1	1	2	2	2	2	2	1	0
0	1	2	2	2	2	2	2	1	0
0	0	0	0	0	0	0	0	0	0